"filename", "language", "Dart", "comment", "blank", "total"
"/Users/abdualhabib/Desktop/bussenes/flutter_project/ams2/lib/config/app_theme.dart", "Dart", 175, 0, 37, 212
"/Users/abdualhabib/Desktop/bussenes/flutter_project/ams2/lib/config/constants.dart", "Dart", 78, 0, 17, 95
"/Users/abdualhabib/Desktop/bussenes/flutter_project/ams2/lib/config/routes.dart", "Dart", 39, 2, 4, 45
"/Users/abdualhabib/Desktop/bussenes/flutter_project/ams2/lib/config/theme.dart", "Dart", 58, 1, 7, 66
"/Users/abdualhabib/Desktop/bussenes/flutter_project/ams2/lib/config/tools/extantion_color.dart", "Dart", 39, 25, 5, 69
"/Users/abdualhabib/Desktop/bussenes/flutter_project/ams2/lib/config/tools/extensions.dart", "Dart", 78, 0, 16, 94
"/Users/abdualhabib/Desktop/bussenes/flutter_project/ams2/lib/config/tools/helper.dart", "Dart", 140, 10, 15, 165
"/Users/abdualhabib/Desktop/bussenes/flutter_project/ams2/lib/config/tools/helpers.dart", "Dart", 0, 136, 14, 150
"/Users/abdualhabib/Desktop/bussenes/flutter_project/ams2/lib/config/tools/keyboard.dart", "Dart", 9, 0, 2, 11
"/Users/abdualhabib/Desktop/bussenes/flutter_project/ams2/lib/config/tools/responsive.dart", "Dart", 32, 5, 10, 47
"/Users/abdualhabib/Desktop/bussenes/flutter_project/ams2/lib/config/tools/utils.dart", "Dart", 51, 0, 10, 61
"/Users/abdualhabib/Desktop/bussenes/flutter_project/ams2/lib/data/constants.dart", "Dart", 42, 2, 7, 51
"/Users/abdualhabib/Desktop/bussenes/flutter_project/ams2/lib/data/datasources/local/setting_local_data_source.dart", "Dart", 24, 0, 7, 31
"/Users/abdualhabib/Desktop/bussenes/flutter_project/ams2/lib/data/datasources/remote/cart_remote_data_source.dart", "Dart", 108, 0, 25, 133
"/Users/abdualhabib/Desktop/bussenes/flutter_project/ams2/lib/data/datasources/remote/category_remote_data_source.dart", "Dart", 32, 3, 10, 45
"/Users/abdualhabib/Desktop/bussenes/flutter_project/ams2/lib/data/datasources/remote/product_remote_data_source.dart", "Dart", 85, 0, 21, 106
"/Users/abdualhabib/Desktop/bussenes/flutter_project/ams2/lib/data/datasources/remote/promo_remote_data_source.dart", "Dart", 31, 3, 10, 44
"/Users/abdualhabib/Desktop/bussenes/flutter_project/ams2/lib/data/datasources/remote/section_remote_data_source.dart", "Dart", 44, 3, 12, 59
"/Users/abdualhabib/Desktop/bussenes/flutter_project/ams2/lib/data/datasources/remote/wishlist_remote_data_source.dart", "Dart", 72, 0, 16, 88
"/Users/abdualhabib/Desktop/bussenes/flutter_project/ams2/lib/data/exception.dart", "Dart", 7, 0, 7, 14
"/Users/abdualhabib/Desktop/bussenes/flutter_project/ams2/lib/data/failure.dart", "Dart", 31, 0, 11, 42
"/Users/abdualhabib/Desktop/bussenes/flutter_project/ams2/lib/data/models/api_response/api_response.dart", "Dart", 28, 0, 6, 34
"/Users/abdualhabib/Desktop/bussenes/flutter_project/ams2/lib/data/models/api_response/cart_response.dart", "Dart", 22, 1, 6, 29
"/Users/abdualhabib/Desktop/bussenes/flutter_project/ams2/lib/data/models/api_response/link.dart", "Dart", 18, 0, 5, 23
"/Users/abdualhabib/Desktop/bussenes/flutter_project/ams2/lib/data/models/api_response/links.dart", "Dart", 23, 0, 5, 28
"/Users/abdualhabib/Desktop/bussenes/flutter_project/ams2/lib/data/models/api_response/meta.dart", "Dart", 68, 0, 7, 75
"/Users/abdualhabib/Desktop/bussenes/flutter_project/ams2/lib/data/models/api_response/model_response.dart", "Dart", 23, 1, 5, 29
"/Users/abdualhabib/Desktop/bussenes/flutter_project/ams2/lib/data/models/cart/cart_item_model.dart", "Dart", 132, 11, 10, 153
"/Users/abdualhabib/Desktop/bussenes/flutter_project/ams2/lib/data/models/cart/cart_model.dart", "Dart", 66, 1, 11, 78
"/Users/abdualhabib/Desktop/bussenes/flutter_project/ams2/lib/data/models/cart/cart_price_model.dart", "Dart", 67, 4, 10, 81
"/Users/abdualhabib/Desktop/bussenes/flutter_project/ams2/lib/data/models/cart/wishlist_item_model.dart", "Dart", 115, 11, 11, 137
"/Users/abdualhabib/Desktop/bussenes/flutter_project/ams2/lib/data/models/category_model.dart", "Dart", 91, 1, 13, 105
"/Users/abdualhabib/Desktop/bussenes/flutter_project/ams2/lib/data/models/discount_model.dart", "Dart", 103, 1, 12, 116
"/Users/abdualhabib/Desktop/bussenes/flutter_project/ams2/lib/data/models/image_model.dart", "Dart", 73, 6, 10, 89
"/Users/abdualhabib/Desktop/bussenes/flutter_project/ams2/lib/data/models/product_category_model.dart", "Dart", 70, 1, 13, 84
"/Users/abdualhabib/Desktop/bussenes/flutter_project/ams2/lib/data/models/product_detail_model.dart", "Dart", 151, 112, 14, 277
"/Users/abdualhabib/Desktop/bussenes/flutter_project/ams2/lib/data/models/product_model.dart", "Dart", 107, 0, 10, 117
"/Users/abdualhabib/Desktop/bussenes/flutter_project/ams2/lib/data/models/product_rate_model.dart", "Dart", 79, 7, 11, 97
"/Users/abdualhabib/Desktop/bussenes/flutter_project/ams2/lib/data/models/promo_model.dart", "Dart", 65, 6, 10, 81
"/Users/abdualhabib/Desktop/bussenes/flutter_project/ams2/lib/data/models/rate_model.dart", "Dart", 95, 7, 13, 115
"/Users/abdualhabib/Desktop/bussenes/flutter_project/ams2/lib/data/models/section_model.dart", "Dart", 98, 1, 12, 111
"/Users/abdualhabib/Desktop/bussenes/flutter_project/ams2/lib/data/models/setting_model.dart", "Dart", 41, 0, 7, 48
"/Users/abdualhabib/Desktop/bussenes/flutter_project/ams2/lib/data/models/temp.dart", "Dart", 0, 0, 2, 2
"/Users/abdualhabib/Desktop/bussenes/flutter_project/ams2/lib/data/repositories/cart_repository_impl.dart", "Dart", 101, 0, 7, 108
"/Users/abdualhabib/Desktop/bussenes/flutter_project/ams2/lib/data/repositories/category_repository.dart", "Dart", 36, 0, 5, 41
"/Users/abdualhabib/Desktop/bussenes/flutter_project/ams2/lib/data/repositories/product_repository_impl.dart", "Dart", 104, 0, 9, 113
"/Users/abdualhabib/Desktop/bussenes/flutter_project/ams2/lib/data/repositories/promo_repository_impl.dart", "Dart", 35, 0, 4, 39
"/Users/abdualhabib/Desktop/bussenes/flutter_project/ams2/lib/data/repositories/section_repository_impl.dart", "Dart", 56, 0, 7, 63
"/Users/abdualhabib/Desktop/bussenes/flutter_project/ams2/lib/data/repositories/setting_repository_impl.dart", "Dart", 17, 0, 5, 22
"/Users/abdualhabib/Desktop/bussenes/flutter_project/ams2/lib/data/repositories/wishlist_repository_impl.dart", "Dart", 78, 0, 6, 84
"/Users/abdualhabib/Desktop/bussenes/flutter_project/ams2/lib/domain/entities/cart/cart.dart", "Dart", 35, 1, 8, 44
"/Users/abdualhabib/Desktop/bussenes/flutter_project/ams2/lib/domain/entities/cart/cart_item.dart", "Dart", 95, 12, 7, 114
"/Users/abdualhabib/Desktop/bussenes/flutter_project/ams2/lib/domain/entities/cart/cart_price.dart", "Dart", 41, 5, 6, 52
"/Users/abdualhabib/Desktop/bussenes/flutter_project/ams2/lib/domain/entities/category.dart", "Dart", 32, 0, 7, 39
"/Users/abdualhabib/Desktop/bussenes/flutter_project/ams2/lib/domain/entities/discount.dart", "Dart", 50, 1, 8, 59
"/Users/abdualhabib/Desktop/bussenes/flutter_project/ams2/lib/domain/entities/filter.dart", "Dart", 65, 0, 13, 78
"/Users/abdualhabib/Desktop/bussenes/flutter_project/ams2/lib/domain/entities/image.dart", "Dart", 27, 6, 3, 36
"/Users/abdualhabib/Desktop/bussenes/flutter_project/ams2/lib/domain/entities/product.dart", "Dart", 47, 1, 4, 52
"/Users/abdualhabib/Desktop/bussenes/flutter_project/ams2/lib/domain/entities/product_category.dart", "Dart", 28, 1, 7, 36
"/Users/abdualhabib/Desktop/bussenes/flutter_project/ams2/lib/domain/entities/product_detail.dart", "Dart", 179, 112, 19, 310
"/Users/abdualhabib/Desktop/bussenes/flutter_project/ams2/lib/domain/entities/product_rate.dart", "Dart", 20, 0, 4, 24
"/Users/abdualhabib/Desktop/bussenes/flutter_project/ams2/lib/domain/entities/promo.dart", "Dart", 23, 3, 4, 30
"/Users/abdualhabib/Desktop/bussenes/flutter_project/ams2/lib/domain/entities/rate.dart", "Dart", 46, 7, 9, 62
"/Users/abdualhabib/Desktop/bussenes/flutter_project/ams2/lib/domain/entities/section.dart", "Dart", 42, 1, 8, 51
"/Users/abdualhabib/Desktop/bussenes/flutter_project/ams2/lib/domain/entities/setting.dart", "Dart", 32, 0, 6, 38
"/Users/abdualhabib/Desktop/bussenes/flutter_project/ams2/lib/domain/entities/sort.dart", "Dart", 39, 0, 9, 48
"/Users/abdualhabib/Desktop/bussenes/flutter_project/ams2/lib/domain/entities/temp.dart", "Dart", 81, 0, 12, 93
"/Users/abdualhabib/Desktop/bussenes/flutter_project/ams2/lib/domain/entities/wishlist.dart", "Dart", 50, 1, 8, 59
"/Users/abdualhabib/Desktop/bussenes/flutter_project/ams2/lib/domain/entities/wishlist_item.dart", "Dart", 77, 12, 6, 95
"/Users/abdualhabib/Desktop/bussenes/flutter_project/ams2/lib/domain/repositories/cart/cart_repository.dart", "Dart", 12, 0, 2, 14
"/Users/abdualhabib/Desktop/bussenes/flutter_project/ams2/lib/domain/repositories/category/category__repository.dart", "Dart", 7, 0, 2, 9
"/Users/abdualhabib/Desktop/bussenes/flutter_project/ams2/lib/domain/repositories/product/product_repository.dart", "Dart", 12, 0, 2, 14
"/Users/abdualhabib/Desktop/bussenes/flutter_project/ams2/lib/domain/repositories/promo/promo_repository.dart", "Dart", 7, 0, 2, 9
"/Users/abdualhabib/Desktop/bussenes/flutter_project/ams2/lib/domain/repositories/section/section_repository.dart", "Dart", 8, 0, 3, 11
"/Users/abdualhabib/Desktop/bussenes/flutter_project/ams2/lib/domain/repositories/setting/setting_repository.dart", "Dart", 5, 0, 3, 8
"/Users/abdualhabib/Desktop/bussenes/flutter_project/ams2/lib/domain/repositories/wishlist/wishlist_repository.dart", "Dart", 10, 0, 4, 14
"/Users/abdualhabib/Desktop/bussenes/flutter_project/ams2/lib/domain/usecases/cart/add_product_to_cart.dart", "Dart", 11, 0, 3, 14
"/Users/abdualhabib/Desktop/bussenes/flutter_project/ams2/lib/domain/usecases/cart/get_cart_items.dart", "Dart", 14, 0, 3, 17
"/Users/abdualhabib/Desktop/bussenes/flutter_project/ams2/lib/domain/usecases/cart/remove_product_from_cart.dart", "Dart", 11, 0, 3, 14
"/Users/abdualhabib/Desktop/bussenes/flutter_project/ams2/lib/domain/usecases/cart/update_product_in_cart.dart", "Dart", 12, 0, 3, 15
"/Users/abdualhabib/Desktop/bussenes/flutter_project/ams2/lib/domain/usecases/category/get_categories.dart", "Dart", 12, 0, 3, 15
"/Users/abdualhabib/Desktop/bussenes/flutter_project/ams2/lib/domain/usecases/product/get_new_products.dart", "Dart", 12, 0, 3, 15
"/Users/abdualhabib/Desktop/bussenes/flutter_project/ams2/lib/domain/usecases/product/get_pobular_products.dart", "Dart", 0, 0, 1, 1
"/Users/abdualhabib/Desktop/bussenes/flutter_project/ams2/lib/domain/usecases/product/get_product_detail.dart", "Dart", 11, 0, 3, 14
"/Users/abdualhabib/Desktop/bussenes/flutter_project/ams2/lib/domain/usecases/product/get_products.dart", "Dart", 12, 0, 3, 15
"/Users/abdualhabib/Desktop/bussenes/flutter_project/ams2/lib/domain/usecases/product/get_similar_product.dart", "Dart", 0, 0, 2, 2
"/Users/abdualhabib/Desktop/bussenes/flutter_project/ams2/lib/domain/usecases/promo/get_pormos.dart", "Dart", 12, 0, 3, 15
"/Users/abdualhabib/Desktop/bussenes/flutter_project/ams2/lib/domain/usecases/section/get_section.dart", "Dart", 11, 0, 2, 13
"/Users/abdualhabib/Desktop/bussenes/flutter_project/ams2/lib/domain/usecases/section/get_sections.dart", "Dart", 12, 0, 3, 15
"/Users/abdualhabib/Desktop/bussenes/flutter_project/ams2/lib/domain/usecases/setting/get_setting.dart", "Dart", 11, 0, 3, 14
"/Users/abdualhabib/Desktop/bussenes/flutter_project/ams2/lib/domain/usecases/setting/update_setting.dart", "Dart", 11, 0, 3, 14
"/Users/abdualhabib/Desktop/bussenes/flutter_project/ams2/lib/domain/usecases/wishlist/add_product_to_wishlist.dart", "Dart", 11, 0, 3, 14
"/Users/abdualhabib/Desktop/bussenes/flutter_project/ams2/lib/domain/usecases/wishlist/get_wishlist_items.dart", "Dart", 14, 0, 3, 17
"/Users/abdualhabib/Desktop/bussenes/flutter_project/ams2/lib/domain/usecases/wishlist/remove_product_from_wishlist.dart", "Dart", 10, 0, 3, 13
"/Users/abdualhabib/Desktop/bussenes/flutter_project/ams2/lib/firebase_options.dart", "Dart", 56, 12, 4, 72
"/Users/abdualhabib/Desktop/bussenes/flutter_project/ams2/lib/injection.dart", "Dart", 115, 34, 45, 194
"/Users/abdualhabib/Desktop/bussenes/flutter_project/ams2/lib/main.dart", "Dart", 157, 2, 10, 169
"/Users/abdualhabib/Desktop/bussenes/flutter_project/ams2/lib/presentation/features/about_us/about_us_screen.dart", "Dart", 16, 0, 3, 19
"/Users/abdualhabib/Desktop/bussenes/flutter_project/ams2/lib/presentation/features/account/account_screen.dart", "Dart", 9, 0, 3, 12
"/Users/abdualhabib/Desktop/bussenes/flutter_project/ams2/lib/presentation/features/account/components/body.dart", "Dart", 126, 4, 7, 137
"/Users/abdualhabib/Desktop/bussenes/flutter_project/ams2/lib/presentation/features/account/components/language_menu.dart", "Dart", 72, 0, 6, 78
"/Users/abdualhabib/Desktop/bussenes/flutter_project/ams2/lib/presentation/features/account/components/profile_menu.dart", "Dart", 67, 0, 4, 71
"/Users/abdualhabib/Desktop/bussenes/flutter_project/ams2/lib/presentation/features/account/components/profile_pic.dart", "Dart", 48, 20, 2, 70
"/Users/abdualhabib/Desktop/bussenes/flutter_project/ams2/lib/presentation/features/account/components/seperator.dart", "Dart", 18, 0, 4, 22
"/Users/abdualhabib/Desktop/bussenes/flutter_project/ams2/lib/presentation/features/account/components/theme_menu.dart", "Dart", 70, 0, 3, 73
"/Users/abdualhabib/Desktop/bussenes/flutter_project/ams2/lib/presentation/features/address/address_screen.dart", "Dart", 16, 0, 3, 19
"/Users/abdualhabib/Desktop/bussenes/flutter_project/ams2/lib/presentation/features/cart/blocs/cart_item/cart_item_bloc.dart", "Dart", 163, 15, 26, 204
"/Users/abdualhabib/Desktop/bussenes/flutter_project/ams2/lib/presentation/features/cart/blocs/cart_item/cart_item_event.dart", "Dart", 42, 1, 11, 54
"/Users/abdualhabib/Desktop/bussenes/flutter_project/ams2/lib/presentation/features/cart/blocs/cart_item/cart_item_state.dart", "Dart", 31, 1, 18, 50
"/Users/abdualhabib/Desktop/bussenes/flutter_project/ams2/lib/presentation/features/cart/blocs/cart_item_button/cart_item_button_bloc.dart", "Dart", 125, 1, 18, 144
"/Users/abdualhabib/Desktop/bussenes/flutter_project/ams2/lib/presentation/features/cart/blocs/cart_item_button/cart_item_button_event.dart", "Dart", 18, 0, 7, 25
"/Users/abdualhabib/Desktop/bussenes/flutter_project/ams2/lib/presentation/features/cart/blocs/cart_item_button/cart_item_button_state.dart", "Dart", 14, 0, 7, 21
"/Users/abdualhabib/Desktop/bussenes/flutter_project/ams2/lib/presentation/features/cart/blocs/cart_item_card/cart_item_card_bloc.dart", "Dart", 141, 0, 20, 161
"/Users/abdualhabib/Desktop/bussenes/flutter_project/ams2/lib/presentation/features/cart/blocs/cart_item_card/cart_item_card_event.dart", "Dart", 24, 0, 9, 33
"/Users/abdualhabib/Desktop/bussenes/flutter_project/ams2/lib/presentation/features/cart/blocs/cart_item_card/cart_item_card_state.dart", "Dart", 16, 0, 9, 25
"/Users/abdualhabib/Desktop/bussenes/flutter_project/ams2/lib/presentation/features/cart/blocs/cart_price/cart_price_bloc.dart", "Dart", 29, 87, 16, 132
"/Users/abdualhabib/Desktop/bussenes/flutter_project/ams2/lib/presentation/features/cart/blocs/cart_price/cart_price_event.dart", "Dart", 18, 0, 7, 25
"/Users/abdualhabib/Desktop/bussenes/flutter_project/ams2/lib/presentation/features/cart/blocs/cart_price/cart_price_state.dart", "Dart", 16, 1, 7, 24
"/Users/abdualhabib/Desktop/bussenes/flutter_project/ams2/lib/presentation/features/cart/view/cart_screen.dart", "Dart", 19, 0, 3, 22
"/Users/abdualhabib/Desktop/bussenes/flutter_project/ams2/lib/presentation/features/cart/view/components/body.dart", "Dart", 166, 2, 13, 181
"/Users/abdualhabib/Desktop/bussenes/flutter_project/ams2/lib/presentation/features/cart/view/components/build.dart", "Dart", 56, 0, 6, 62
"/Users/abdualhabib/Desktop/bussenes/flutter_project/ams2/lib/presentation/features/cart/view/components/card_item/card_builder.dart", "Dart", 116, 8, 8, 132
"/Users/abdualhabib/Desktop/bussenes/flutter_project/ams2/lib/presentation/features/cart/view/components/card_item/card_quantity.dart", "Dart", 71, 0, 4, 75
"/Users/abdualhabib/Desktop/bussenes/flutter_project/ams2/lib/presentation/features/cart/view/components/card_item/cart_widget.dart", "Dart", 181, 13, 7, 201
"/Users/abdualhabib/Desktop/bussenes/flutter_project/ams2/lib/presentation/features/cart/view/components/check_out_card.dart", "Dart", 210, 5, 6, 221
"/Users/abdualhabib/Desktop/bussenes/flutter_project/ams2/lib/presentation/features/cart/view/components/custome_app_bar.dart", "Dart", 60, 1, 3, 64
"/Users/abdualhabib/Desktop/bussenes/flutter_project/ams2/lib/presentation/features/cart/view/components/custome_app_bar_cart.dart", "Dart", 56, 1, 3, 60
"/Users/abdualhabib/Desktop/bussenes/flutter_project/ams2/lib/presentation/features/cart/view/components/header_phone.dart", "Dart", 50, 0, 4, 54
"/Users/abdualhabib/Desktop/bussenes/flutter_project/ams2/lib/presentation/features/cart/view/components/list_loading.dart", "Dart", 21, 0, 4, 25
"/Users/abdualhabib/Desktop/bussenes/flutter_project/ams2/lib/presentation/features/cart/view/components/simmer/cart_shwimar.dart", "Dart", 156, 9, 7, 172
"/Users/abdualhabib/Desktop/bussenes/flutter_project/ams2/lib/presentation/features/cart/view/components/simmer/image_shwimmer.dart", "Dart", 17, 0, 3, 20
"/Users/abdualhabib/Desktop/bussenes/flutter_project/ams2/lib/presentation/features/cart/view/components/state_ui/loaded.dart", "Dart", 51, 3, 4, 58
"/Users/abdualhabib/Desktop/bussenes/flutter_project/ams2/lib/presentation/features/cart/view/components/state_ui/loading.dart", "Dart", 28, 1, 5, 34
"/Users/abdualhabib/Desktop/bussenes/flutter_project/ams2/lib/presentation/features/currency/currency_screen.dart", "Dart", 16, 0, 3, 19
"/Users/abdualhabib/Desktop/bussenes/flutter_project/ams2/lib/presentation/features/details/blocs/cart_button/cart_button_bloc.dart", "Dart", 165, 6, 23, 194
"/Users/abdualhabib/Desktop/bussenes/flutter_project/ams2/lib/presentation/features/details/blocs/cart_button/cart_button_event.dart", "Dart", 28, 0, 9, 37
"/Users/abdualhabib/Desktop/bussenes/flutter_project/ams2/lib/presentation/features/details/blocs/cart_button/cart_button_state.dart", "Dart", 14, 0, 7, 21
"/Users/abdualhabib/Desktop/bussenes/flutter_project/ams2/lib/presentation/features/details/blocs/prod_detail/prod_detail_bloc.dart", "Dart", 72, 4, 16, 92
"/Users/abdualhabib/Desktop/bussenes/flutter_project/ams2/lib/presentation/features/details/blocs/prod_detail/prod_detail_event.dart", "Dart", 13, 0, 5, 18
"/Users/abdualhabib/Desktop/bussenes/flutter_project/ams2/lib/presentation/features/details/blocs/prod_detail/prod_detail_state.dart", "Dart", 20, 0, 10, 30
"/Users/abdualhabib/Desktop/bussenes/flutter_project/ams2/lib/presentation/features/details/components/body.dart", "Dart", 63, 11, 6, 80
"/Users/abdualhabib/Desktop/bussenes/flutter_project/ams2/lib/presentation/features/details/components/buttons/buttons.dart", "Dart", 51, 1, 5, 57
"/Users/abdualhabib/Desktop/bussenes/flutter_project/ams2/lib/presentation/features/details/components/buttons/cart_button.dart", "Dart", 37, 1, 5, 43
"/Users/abdualhabib/Desktop/bussenes/flutter_project/ams2/lib/presentation/features/details/components/buttons/cart_number.dart", "Dart", 103, 1, 6, 110
"/Users/abdualhabib/Desktop/bussenes/flutter_project/ams2/lib/presentation/features/details/components/buttons/default_button.dart", "Dart", 51, 0, 3, 54
"/Users/abdualhabib/Desktop/bussenes/flutter_project/ams2/lib/presentation/features/details/components/color_dots.dart", "Dart", 0, 81, 0, 81
"/Users/abdualhabib/Desktop/bussenes/flutter_project/ams2/lib/presentation/features/details/components/custom_app_bar.dart", "Dart", 52, 21, 4, 77
"/Users/abdualhabib/Desktop/bussenes/flutter_project/ams2/lib/presentation/features/details/components/likes_button.dart", "Dart", 63, 0, 5, 68
"/Users/abdualhabib/Desktop/bussenes/flutter_project/ams2/lib/presentation/features/details/components/product_description/description.dart", "Dart", 62, 0, 4, 66
"/Users/abdualhabib/Desktop/bussenes/flutter_project/ams2/lib/presentation/features/details/components/product_description/description_shimmer.dart", "Dart", 132, 2, 4, 138
"/Users/abdualhabib/Desktop/bussenes/flutter_project/ams2/lib/presentation/features/details/components/product_description/detail_texts.dart", "Dart", 134, 3, 8, 145
"/Users/abdualhabib/Desktop/bussenes/flutter_project/ams2/lib/presentation/features/details/components/product_description/product_description.dart", "Dart", 33, 0, 7, 40
"/Users/abdualhabib/Desktop/bussenes/flutter_project/ams2/lib/presentation/features/details/components/product_description/product_images.dart", "Dart", 177, 5, 9, 191
"/Users/abdualhabib/Desktop/bussenes/flutter_project/ams2/lib/presentation/features/details/components/product_option.dart", "Dart", 283, 2, 18, 303
"/Users/abdualhabib/Desktop/bussenes/flutter_project/ams2/lib/presentation/features/details/components/rate_and_comment/rate_card.dart", "Dart", 98, 0, 5, 103
"/Users/abdualhabib/Desktop/bussenes/flutter_project/ams2/lib/presentation/features/details/components/rate_and_comment/reviews_comments.dart", "Dart", 56, 0, 4, 60
"/Users/abdualhabib/Desktop/bussenes/flutter_project/ams2/lib/presentation/features/details/components/shppping_details.dart", "Dart", 0, 126, 3, 129
"/Users/abdualhabib/Desktop/bussenes/flutter_project/ams2/lib/presentation/features/details/components/similar_product.dart", "Dart", 29, 2, 5, 36
"/Users/abdualhabib/Desktop/bussenes/flutter_project/ams2/lib/presentation/features/details/components/top_rounded_container.dart", "Dart", 26, 0, 4, 30
"/Users/abdualhabib/Desktop/bussenes/flutter_project/ams2/lib/presentation/features/details/product_detail_screen.dart", "Dart", 138, 0, 11, 149
"/Users/abdualhabib/Desktop/bussenes/flutter_project/ams2/lib/presentation/features/help/help_screen.dart", "Dart", 16, 0, 3, 19
"/Users/abdualhabib/Desktop/bussenes/flutter_project/ams2/lib/presentation/features/home/blocs/food_category/food_category_bloc.dart", "Dart", 37, 4, 9, 50
"/Users/abdualhabib/Desktop/bussenes/flutter_project/ams2/lib/presentation/features/home/blocs/food_category/food_category_event.dart", "Dart", 7, 0, 4, 11
"/Users/abdualhabib/Desktop/bussenes/flutter_project/ams2/lib/presentation/features/home/blocs/food_category/food_category_state.dart", "Dart", 21, 1, 11, 33
"/Users/abdualhabib/Desktop/bussenes/flutter_project/ams2/lib/presentation/features/home/blocs/new_product/new_product_bloc.dart", "Dart", 56, 4, 13, 73
"/Users/abdualhabib/Desktop/bussenes/flutter_project/ams2/lib/presentation/features/home/blocs/new_product/new_product_event.dart", "Dart", 11, 0, 6, 17
"/Users/abdualhabib/Desktop/bussenes/flutter_project/ams2/lib/presentation/features/home/blocs/new_product/new_product_state.dart", "Dart", 21, 1, 11, 33
"/Users/abdualhabib/Desktop/bussenes/flutter_project/ams2/lib/presentation/features/home/blocs/popular_product/popular_product_bloc.dart", "Dart", 57, 4, 13, 74
"/Users/abdualhabib/Desktop/bussenes/flutter_project/ams2/lib/presentation/features/home/blocs/popular_product/popular_product_event.dart", "Dart", 11, 0, 6, 17
"/Users/abdualhabib/Desktop/bussenes/flutter_project/ams2/lib/presentation/features/home/blocs/popular_product/popular_product_state.dart", "Dart", 21, 1, 11, 33
"/Users/abdualhabib/Desktop/bussenes/flutter_project/ams2/lib/presentation/features/home/blocs/promo/promo_bloc.dart", "Dart", 39, 4, 9, 52
"/Users/abdualhabib/Desktop/bussenes/flutter_project/ams2/lib/presentation/features/home/blocs/promo/promo_event.dart", "Dart", 7, 0, 4, 11
"/Users/abdualhabib/Desktop/bussenes/flutter_project/ams2/lib/presentation/features/home/blocs/promo/promo_state.dart", "Dart", 21, 1, 11, 33
"/Users/abdualhabib/Desktop/bussenes/flutter_project/ams2/lib/presentation/features/home/components/body.dart", "Dart", 72, 25, 8, 105
"/Users/abdualhabib/Desktop/bussenes/flutter_project/ams2/lib/presentation/features/home/components/food_categories.dart", "Dart", 55, 1, 6, 62
"/Users/abdualhabib/Desktop/bussenes/flutter_project/ams2/lib/presentation/features/home/components/home_header.dart", "Dart", 25, 1, 4, 30
"/Users/abdualhabib/Desktop/bussenes/flutter_project/ams2/lib/presentation/features/home/components/new_product.dart", "Dart", 56, 0, 6, 62
"/Users/abdualhabib/Desktop/bussenes/flutter_project/ams2/lib/presentation/features/home/components/popular_product.dart", "Dart", 60, 0, 6, 66
"/Users/abdualhabib/Desktop/bussenes/flutter_project/ams2/lib/presentation/features/home/components/promo_banner.dart", "Dart", 52, 1, 7, 60
"/Users/abdualhabib/Desktop/bussenes/flutter_project/ams2/lib/presentation/features/home/components/promo_slider.dart", "Dart", 69, 1, 5, 75
"/Users/abdualhabib/Desktop/bussenes/flutter_project/ams2/lib/presentation/features/home/components/shimer_slider.dart", "Dart", 73, 1, 8, 82
"/Users/abdualhabib/Desktop/bussenes/flutter_project/ams2/lib/presentation/features/home/components/temp_search.dart", "Dart", 66, 0, 3, 69
"/Users/abdualhabib/Desktop/bussenes/flutter_project/ams2/lib/presentation/features/home/home_screen.dart", "Dart", 12, 0, 4, 16
"/Users/abdualhabib/Desktop/bussenes/flutter_project/ams2/lib/presentation/features/login/components/body.dart", "Dart", 186, 8, 12, 206
"/Users/abdualhabib/Desktop/bussenes/flutter_project/ams2/lib/presentation/features/login/components/phone_number.dart", "Dart", 33, 6, 4, 43
"/Users/abdualhabib/Desktop/bussenes/flutter_project/ams2/lib/presentation/features/login/login_screen.dart", "Dart", 30, 0, 4, 34
"/Users/abdualhabib/Desktop/bussenes/flutter_project/ams2/lib/presentation/features/main/components/cart_counter.dart", "Dart", 45, 0, 3, 48
"/Users/abdualhabib/Desktop/bussenes/flutter_project/ams2/lib/presentation/features/main/components/custom_bottom_tab_bar.dart", "Dart", 217, 94, 31, 342
"/Users/abdualhabib/Desktop/bussenes/flutter_project/ams2/lib/presentation/features/main/components/custome_tab_scaffold.dart", "Dart", 295, 292, 52, 639
"/Users/abdualhabib/Desktop/bussenes/flutter_project/ams2/lib/presentation/features/main/main_screen.dart", "Dart", 134, 2, 11, 147
"/Users/abdualhabib/Desktop/bussenes/flutter_project/ams2/lib/presentation/features/notification/notification_screen.dart", "Dart", 16, 0, 3, 19
"/Users/abdualhabib/Desktop/bussenes/flutter_project/ams2/lib/presentation/features/order_history/order_history_screen.dart", "Dart", 16, 0, 3, 19
"/Users/abdualhabib/Desktop/bussenes/flutter_project/ams2/lib/presentation/features/products/bloc/categories_filter/categories_filter_bloc.dart", "Dart", 99, 10, 19, 128
"/Users/abdualhabib/Desktop/bussenes/flutter_project/ams2/lib/presentation/features/products/bloc/categories_filter/categories_filter_event.dart", "Dart", 34, 3, 8, 45
"/Users/abdualhabib/Desktop/bussenes/flutter_project/ams2/lib/presentation/features/products/bloc/categories_filter/categories_filter_state.dart", "Dart", 36, 0, 15, 51
"/Users/abdualhabib/Desktop/bussenes/flutter_project/ams2/lib/presentation/features/products/bloc/products/products_bloc.dart", "Dart", 167, 12, 28, 207
"/Users/abdualhabib/Desktop/bussenes/flutter_project/ams2/lib/presentation/features/products/bloc/products/products_event.dart", "Dart", 38, 0, 12, 50
"/Users/abdualhabib/Desktop/bussenes/flutter_project/ams2/lib/presentation/features/products/bloc/products/products_state.dart", "Dart", 27, 1, 16, 44
"/Users/abdualhabib/Desktop/bussenes/flutter_project/ams2/lib/presentation/features/products/bloc/section_filter/section_filter_bloc.dart", "Dart", 85, 10, 17, 112
"/Users/abdualhabib/Desktop/bussenes/flutter_project/ams2/lib/presentation/features/products/bloc/section_filter/section_filter_event.dart", "Dart", 29, 2, 8, 39
"/Users/abdualhabib/Desktop/bussenes/flutter_project/ams2/lib/presentation/features/products/bloc/section_filter/section_filter_state.dart", "Dart", 35, 0, 14, 49
"/Users/abdualhabib/Desktop/bussenes/flutter_project/ams2/lib/presentation/features/products/list_title.dart", "Dart", 21, 1, 2, 24
"/Users/abdualhabib/Desktop/bussenes/flutter_project/ams2/lib/presentation/features/products/products_screen.dart", "Dart", 57, 0, 7, 64
"/Users/abdualhabib/Desktop/bussenes/flutter_project/ams2/lib/presentation/features/products/view/components/body.dart", "Dart", 185, 2, 14, 201
"/Users/abdualhabib/Desktop/bussenes/flutter_project/ams2/lib/presentation/features/products/view/components/build.dart", "Dart", 56, 1, 6, 63
"/Users/abdualhabib/Desktop/bussenes/flutter_project/ams2/lib/presentation/features/products/view/components/custome_app_bar_products.dart", "Dart", 60, 2, 4, 66
"/Users/abdualhabib/Desktop/bussenes/flutter_project/ams2/lib/presentation/features/products/view/components/filter/filter_chips_category.dart", "Dart", 136, 0, 7, 143
"/Users/abdualhabib/Desktop/bussenes/flutter_project/ams2/lib/presentation/features/products/view/components/filter/filter_chips_section.dart", "Dart", 136, 0, 7, 143
"/Users/abdualhabib/Desktop/bussenes/flutter_project/ams2/lib/presentation/features/products/view/components/filter/section_filter_shimer.dart", "Dart", 0, 0, 1, 1
"/Users/abdualhabib/Desktop/bussenes/flutter_project/ams2/lib/presentation/features/products/view/components/header_phone.dart", "Dart", 50, 0, 4, 54
"/Users/abdualhabib/Desktop/bussenes/flutter_project/ams2/lib/presentation/features/products/view/components/list_type.dart", "Dart", 44, 1, 4, 49
"/Users/abdualhabib/Desktop/bussenes/flutter_project/ams2/lib/presentation/features/products/view/components/result_count.dart", "Dart", 30, 0, 4, 34
"/Users/abdualhabib/Desktop/bussenes/flutter_project/ams2/lib/presentation/features/products/view/components/sort_and_filter.dart", "Dart", 75, 1, 6, 82
"/Users/abdualhabib/Desktop/bussenes/flutter_project/ams2/lib/presentation/features/products/view/components/state_ui/loaded.dart", "Dart", 32, 0, 3, 35
"/Users/abdualhabib/Desktop/bussenes/flutter_project/ams2/lib/presentation/features/products/view/components/state_ui/loading.dart", "Dart", 25, 0, 3, 28
"/Users/abdualhabib/Desktop/bussenes/flutter_project/ams2/lib/presentation/features/profile/profile_screen.dart", "Dart", 16, 0, 3, 19
"/Users/abdualhabib/Desktop/bussenes/flutter_project/ams2/lib/presentation/features/save_later/blocs/save_later_item/save_later_item_bloc.dart", "Dart", 163, 15, 26, 204
"/Users/abdualhabib/Desktop/bussenes/flutter_project/ams2/lib/presentation/features/save_later/blocs/save_later_item/save_later_item_event.dart", "Dart", 42, 1, 11, 54
"/Users/abdualhabib/Desktop/bussenes/flutter_project/ams2/lib/presentation/features/save_later/blocs/save_later_item/save_later_item_state.dart", "Dart", 31, 1, 18, 50
"/Users/abdualhabib/Desktop/bussenes/flutter_project/ams2/lib/presentation/features/save_later/blocs/save_later_item_button/save_later_item_button_bloc.dart", "Dart", 130, 1, 18, 149
"/Users/abdualhabib/Desktop/bussenes/flutter_project/ams2/lib/presentation/features/save_later/blocs/save_later_item_button/save_later_item_button_event.dart", "Dart", 18, 0, 7, 25
"/Users/abdualhabib/Desktop/bussenes/flutter_project/ams2/lib/presentation/features/save_later/blocs/save_later_item_button/save_later_item_button_state.dart", "Dart", 14, 0, 7, 21
"/Users/abdualhabib/Desktop/bussenes/flutter_project/ams2/lib/presentation/features/save_later/blocs/save_later_item_card/save_later_item_card_bloc.dart", "Dart", 143, 0, 20, 163
"/Users/abdualhabib/Desktop/bussenes/flutter_project/ams2/lib/presentation/features/save_later/blocs/save_later_item_card/save_later_item_card_event.dart", "Dart", 24, 0, 9, 33
"/Users/abdualhabib/Desktop/bussenes/flutter_project/ams2/lib/presentation/features/save_later/blocs/save_later_item_card/save_later_item_card_state.dart", "Dart", 16, 0, 9, 25
"/Users/abdualhabib/Desktop/bussenes/flutter_project/ams2/lib/presentation/features/save_later/view/components/body.dart", "Dart", 162, 2, 13, 177
"/Users/abdualhabib/Desktop/bussenes/flutter_project/ams2/lib/presentation/features/save_later/view/components/build.dart", "Dart", 58, 0, 6, 64
"/Users/abdualhabib/Desktop/bussenes/flutter_project/ams2/lib/presentation/features/save_later/view/components/custome_app_bar.dart", "Dart", 57, 1, 3, 61
"/Users/abdualhabib/Desktop/bussenes/flutter_project/ams2/lib/presentation/features/save_later/view/components/custome_app_bar_cart.dart", "Dart", 67, 1, 3, 71
"/Users/abdualhabib/Desktop/bussenes/flutter_project/ams2/lib/presentation/features/save_later/view/components/header_phone.dart", "Dart", 50, 0, 4, 54
"/Users/abdualhabib/Desktop/bussenes/flutter_project/ams2/lib/presentation/features/save_later/view/components/list_loading.dart", "Dart", 21, 0, 4, 25
"/Users/abdualhabib/Desktop/bussenes/flutter_project/ams2/lib/presentation/features/save_later/view/components/save_later_item/card_builder.dart", "Dart", 116, 8, 8, 132
"/Users/abdualhabib/Desktop/bussenes/flutter_project/ams2/lib/presentation/features/save_later/view/components/save_later_item/card_quantity.dart", "Dart", 71, 0, 4, 75
"/Users/abdualhabib/Desktop/bussenes/flutter_project/ams2/lib/presentation/features/save_later/view/components/save_later_item/cart_widget.dart", "Dart", 182, 13, 7, 202
"/Users/abdualhabib/Desktop/bussenes/flutter_project/ams2/lib/presentation/features/save_later/view/components/simmer/image_shwimmer.dart", "Dart", 17, 0, 3, 20
"/Users/abdualhabib/Desktop/bussenes/flutter_project/ams2/lib/presentation/features/save_later/view/components/simmer/save_later_shwimar.dart", "Dart", 156, 9, 7, 172
"/Users/abdualhabib/Desktop/bussenes/flutter_project/ams2/lib/presentation/features/save_later/view/components/state_ui/loaded.dart", "Dart", 52, 3, 4, 59
"/Users/abdualhabib/Desktop/bussenes/flutter_project/ams2/lib/presentation/features/save_later/view/components/state_ui/loading.dart", "Dart", 28, 1, 5, 34
"/Users/abdualhabib/Desktop/bussenes/flutter_project/ams2/lib/presentation/features/save_later/view/save_later_screen.dart", "Dart", 12, 0, 3, 15
"/Users/abdualhabib/Desktop/bussenes/flutter_project/ams2/lib/presentation/features/search/blocs/bloc/search_bloc.dart", "Dart", 11, 1, 3, 15
"/Users/abdualhabib/Desktop/bussenes/flutter_project/ams2/lib/presentation/features/search/blocs/bloc/search_event.dart", "Dart", 6, 0, 3, 9
"/Users/abdualhabib/Desktop/bussenes/flutter_project/ams2/lib/presentation/features/search/blocs/bloc/search_state.dart", "Dart", 22, 7, 17, 46
"/Users/abdualhabib/Desktop/bussenes/flutter_project/ams2/lib/presentation/features/search/view/search_screen.dart", "Dart", 0, 81, 6, 87
"/Users/abdualhabib/Desktop/bussenes/flutter_project/ams2/lib/presentation/features/section/blocs/section_bloc.dart", "Dart", 120, 10, 20, 150
"/Users/abdualhabib/Desktop/bussenes/flutter_project/ams2/lib/presentation/features/section/blocs/section_event.dart", "Dart", 26, 1, 7, 34
"/Users/abdualhabib/Desktop/bussenes/flutter_project/ams2/lib/presentation/features/section/blocs/section_state.dart", "Dart", 27, 1, 16, 44
"/Users/abdualhabib/Desktop/bussenes/flutter_project/ams2/lib/presentation/features/section/view/components/body.dart", "Dart", 151, 5, 13, 169
"/Users/abdualhabib/Desktop/bussenes/flutter_project/ams2/lib/presentation/features/section/view/components/build.dart", "Dart", 56, 0, 6, 62
"/Users/abdualhabib/Desktop/bussenes/flutter_project/ams2/lib/presentation/features/section/view/components/grid_loading.dart", "Dart", 29, 0, 4, 33
"/Users/abdualhabib/Desktop/bussenes/flutter_project/ams2/lib/presentation/features/section/view/components/header_phone.dart", "Dart", 50, 0, 4, 54
"/Users/abdualhabib/Desktop/bussenes/flutter_project/ams2/lib/presentation/features/section/view/components/section_widget.dart", "Dart", 54, 0, 4, 58
"/Users/abdualhabib/Desktop/bussenes/flutter_project/ams2/lib/presentation/features/section/view/components/simmer/image_shwimmer.dart", "Dart", 17, 0, 3, 20
"/Users/abdualhabib/Desktop/bussenes/flutter_project/ams2/lib/presentation/features/section/view/components/simmer/section_shwimar.dart", "Dart", 47, 0, 3, 50
"/Users/abdualhabib/Desktop/bussenes/flutter_project/ams2/lib/presentation/features/section/view/components/state_ui/loaded.dart", "Dart", 50, 1, 4, 55
"/Users/abdualhabib/Desktop/bussenes/flutter_project/ams2/lib/presentation/features/section/view/components/state_ui/loading.dart", "Dart", 36, 1, 5, 42
"/Users/abdualhabib/Desktop/bussenes/flutter_project/ams2/lib/presentation/features/section/view/sections_screen.dart", "Dart", 10, 0, 3, 13
"/Users/abdualhabib/Desktop/bussenes/flutter_project/ams2/lib/presentation/features/splash/components/body.dart", "Dart", 136, 3, 9, 148
"/Users/abdualhabib/Desktop/bussenes/flutter_project/ams2/lib/presentation/features/splash/components/splash_content.dart", "Dart", 67, 4, 7, 78
"/Users/abdualhabib/Desktop/bussenes/flutter_project/ams2/lib/presentation/features/splash/splash_screen.dart", "Dart", 17, 0, 6, 23
"/Users/abdualhabib/Desktop/bussenes/flutter_project/ams2/lib/presentation/features/test/test_screen.dart", "Dart", 21, 0, 3, 24
"/Users/abdualhabib/Desktop/bussenes/flutter_project/ams2/lib/presentation/features/wishlist/blocs/wishlist_item/wishlist_item_bloc.dart", "Dart", 161, 15, 26, 202
"/Users/abdualhabib/Desktop/bussenes/flutter_project/ams2/lib/presentation/features/wishlist/blocs/wishlist_item/wishlist_item_event.dart", "Dart", 34, 1, 9, 44
"/Users/abdualhabib/Desktop/bussenes/flutter_project/ams2/lib/presentation/features/wishlist/blocs/wishlist_item/wishlist_item_state.dart", "Dart", 31, 1, 18, 50
"/Users/abdualhabib/Desktop/bussenes/flutter_project/ams2/lib/presentation/features/wishlist/blocs/wishlist_item_card/wishlist_item_card_bloc.dart", "Dart", 109, 0, 15, 124
"/Users/abdualhabib/Desktop/bussenes/flutter_project/ams2/lib/presentation/features/wishlist/blocs/wishlist_item_card/wishlist_item_card_event.dart", "Dart", 22, 2, 9, 33
"/Users/abdualhabib/Desktop/bussenes/flutter_project/ams2/lib/presentation/features/wishlist/blocs/wishlist_item_card/wishlist_item_card_state.dart", "Dart", 17, 1, 9, 27
"/Users/abdualhabib/Desktop/bussenes/flutter_project/ams2/lib/presentation/features/wishlist/view/components/body.dart", "Dart", 163, 2, 13, 178
"/Users/abdualhabib/Desktop/bussenes/flutter_project/ams2/lib/presentation/features/wishlist/view/components/build.dart", "Dart", 56, 0, 6, 62
"/Users/abdualhabib/Desktop/bussenes/flutter_project/ams2/lib/presentation/features/wishlist/view/components/custome_app_bar_wishlist.dart", "Dart", 66, 1, 3, 70
"/Users/abdualhabib/Desktop/bussenes/flutter_project/ams2/lib/presentation/features/wishlist/view/components/header_phone.dart", "Dart", 50, 0, 4, 54
"/Users/abdualhabib/Desktop/bussenes/flutter_project/ams2/lib/presentation/features/wishlist/view/components/list_loading.dart", "Dart", 21, 0, 4, 25
"/Users/abdualhabib/Desktop/bussenes/flutter_project/ams2/lib/presentation/features/wishlist/view/components/simmer/image_shwimmer.dart", "Dart", 17, 0, 3, 20
"/Users/abdualhabib/Desktop/bussenes/flutter_project/ams2/lib/presentation/features/wishlist/view/components/simmer/wishlist_shwimar.dart", "Dart", 156, 9, 7, 172
"/Users/abdualhabib/Desktop/bussenes/flutter_project/ams2/lib/presentation/features/wishlist/view/components/state_ui/loaded.dart", "Dart", 42, 2, 3, 47
"/Users/abdualhabib/Desktop/bussenes/flutter_project/ams2/lib/presentation/features/wishlist/view/components/state_ui/loading.dart", "Dart", 28, 1, 5, 34
"/Users/abdualhabib/Desktop/bussenes/flutter_project/ams2/lib/presentation/features/wishlist/view/components/wishlist_item/wishlist_builder.dart", "Dart", 111, 7, 7, 125
"/Users/abdualhabib/Desktop/bussenes/flutter_project/ams2/lib/presentation/features/wishlist/view/components/wishlist_item/wishlist_widget.dart", "Dart", 205, 14, 7, 226
"/Users/abdualhabib/Desktop/bussenes/flutter_project/ams2/lib/presentation/features/wishlist/view/wishlist_screen.dart", "Dart", 14, 0, 3, 17
"/Users/abdualhabib/Desktop/bussenes/flutter_project/ams2/lib/presentation/other/blocs/setting/setting_bloc.dart", "Dart", 25, 0, 6, 31
"/Users/abdualhabib/Desktop/bussenes/flutter_project/ams2/lib/presentation/other/blocs/setting/setting_event.dart", "Dart", 14, 0, 7, 21
"/Users/abdualhabib/Desktop/bussenes/flutter_project/ams2/lib/presentation/other/blocs/setting/setting_state.dart", "Dart", 13, 0, 5, 18
"/Users/abdualhabib/Desktop/bussenes/flutter_project/ams2/lib/presentation/other/blocs/temp.dart", "Dart", 0, 0, 1, 1
"/Users/abdualhabib/Desktop/bussenes/flutter_project/ams2/lib/presentation/widgets/categories/category_card.dart", "Dart", 47, 0, 4, 51
"/Users/abdualhabib/Desktop/bussenes/flutter_project/ams2/lib/presentation/widgets/categories/horizantal_category.dart", "Dart", 50, 3, 3, 56
"/Users/abdualhabib/Desktop/bussenes/flutter_project/ams2/lib/presentation/widgets/categories/horizantal_loaded.dart", "Dart", 53, 0, 4, 57
"/Users/abdualhabib/Desktop/bussenes/flutter_project/ams2/lib/presentation/widgets/categories/horizantal_loading.dart", "Dart", 29, 1, 3, 33
"/Users/abdualhabib/Desktop/bussenes/flutter_project/ams2/lib/presentation/widgets/change_ip_form.dart", "Dart", 71, 3, 9, 83
"/Users/abdualhabib/Desktop/bussenes/flutter_project/ams2/lib/presentation/widgets/custome_floating_action_button.dart", "Dart", 25, 0, 4, 29
"/Users/abdualhabib/Desktop/bussenes/flutter_project/ams2/lib/presentation/widgets/custome_image.dart", "Dart", 42, 1, 4, 47
"/Users/abdualhabib/Desktop/bussenes/flutter_project/ams2/lib/presentation/widgets/custome_space.dart", "Dart", 11, 0, 3, 14
"/Users/abdualhabib/Desktop/bussenes/flutter_project/ams2/lib/presentation/widgets/default_button_with_riple.dart", "Dart", 61, 0, 3, 64
"/Users/abdualhabib/Desktop/bussenes/flutter_project/ams2/lib/presentation/widgets/empty.dart", "Dart", 36, 0, 3, 39
"/Users/abdualhabib/Desktop/bussenes/flutter_project/ams2/lib/presentation/widgets/error.dart", "Dart", 69, 0, 4, 73
"/Users/abdualhabib/Desktop/bussenes/flutter_project/ams2/lib/presentation/widgets/error_dialog.dart", "Dart", 8, 0, 3, 11
"/Users/abdualhabib/Desktop/bussenes/flutter_project/ams2/lib/presentation/widgets/form_error.dart", "Dart", 28, 0, 4, 32
"/Users/abdualhabib/Desktop/bussenes/flutter_project/ams2/lib/presentation/widgets/header.dart", "Dart", 45, 0, 3, 48
"/Users/abdualhabib/Desktop/bussenes/flutter_project/ams2/lib/presentation/widgets/header_with_back.dart", "Dart", 45, 0, 3, 48
"/Users/abdualhabib/Desktop/bussenes/flutter_project/ams2/lib/presentation/widgets/icon_with_button.dart", "Dart", 73, 0, 4, 77
"/Users/abdualhabib/Desktop/bussenes/flutter_project/ams2/lib/presentation/widgets/language_widget.dart", "Dart", 98, 2, 12, 112
"/Users/abdualhabib/Desktop/bussenes/flutter_project/ams2/lib/presentation/widgets/list_background.dart", "Dart", 35, 0, 3, 38
"/Users/abdualhabib/Desktop/bussenes/flutter_project/ams2/lib/presentation/widgets/modal_inside_model.dart", "Dart", 80, 5, 6, 91
"/Users/abdualhabib/Desktop/bussenes/flutter_project/ams2/lib/presentation/widgets/null_image.dart", "Dart", 20, 0, 3, 23
"/Users/abdualhabib/Desktop/bussenes/flutter_project/ams2/lib/presentation/widgets/primary_button.dart", "Dart", 49, 1, 4, 54
"/Users/abdualhabib/Desktop/bussenes/flutter_project/ams2/lib/presentation/widgets/primary_button_outline.dart", "Dart", 44, 0, 3, 47
"/Users/abdualhabib/Desktop/bussenes/flutter_project/ams2/lib/presentation/widgets/product/home/home_loaded.dart", "Dart", 36, 0, 3, 39
"/Users/abdualhabib/Desktop/bussenes/flutter_project/ams2/lib/presentation/widgets/product/home/home_loading.dart", "Dart", 30, 1, 3, 34
"/Users/abdualhabib/Desktop/bussenes/flutter_project/ams2/lib/presentation/widgets/product/home/home_product.dart", "Dart", 50, 2, 3, 55
"/Users/abdualhabib/Desktop/bussenes/flutter_project/ams2/lib/presentation/widgets/product/home/home_product_card.dart", "Dart", 204, 14, 11, 229
"/Users/abdualhabib/Desktop/bussenes/flutter_project/ams2/lib/presentation/widgets/product/horizantal/horiantal_loading.dart", "Dart", 34, 2, 5, 41
"/Users/abdualhabib/Desktop/bussenes/flutter_project/ams2/lib/presentation/widgets/product/horizantal/horizantal_loaded.dart", "Dart", 33, 1, 4, 38
"/Users/abdualhabib/Desktop/bussenes/flutter_project/ams2/lib/presentation/widgets/product/horizantal/horizantal_product_card.dart", "Dart", 204, 14, 11, 229
"/Users/abdualhabib/Desktop/bussenes/flutter_project/ams2/lib/presentation/widgets/product/vertical/vertical_loaded.dart", "Dart", 28, 0, 4, 32
"/Users/abdualhabib/Desktop/bussenes/flutter_project/ams2/lib/presentation/widgets/product/vertical/vertical_loading.dart", "Dart", 29, 1, 4, 34
"/Users/abdualhabib/Desktop/bussenes/flutter_project/ams2/lib/presentation/widgets/product/vertical/vertical_product_card.dart", "Dart", 202, 23, 7, 232
"/Users/abdualhabib/Desktop/bussenes/flutter_project/ams2/lib/presentation/widgets/rounded_icon_btn.dart", "Dart", 46, 0, 4, 50
"/Users/abdualhabib/Desktop/bussenes/flutter_project/ams2/lib/presentation/widgets/section_title.dart", "Dart", 32, 0, 4, 36
"/Users/abdualhabib/Desktop/bussenes/flutter_project/ams2/lib/presentation/widgets/shimer/category/category_home.dart", "Dart", 34, 0, 3, 37
"/Users/abdualhabib/Desktop/bussenes/flutter_project/ams2/lib/presentation/widgets/shimer/chip/chip_filter_list.dart", "Dart", 24, 0, 2, 26
"/Users/abdualhabib/Desktop/bussenes/flutter_project/ams2/lib/presentation/widgets/shimer/chip/chip_shimer.dart", "Dart", 44, 0, 2, 46
"/Users/abdualhabib/Desktop/bussenes/flutter_project/ams2/lib/presentation/widgets/shimer/chip/image_chip_shimer.dart", "Dart", 17, 0, 3, 20
"/Users/abdualhabib/Desktop/bussenes/flutter_project/ams2/lib/presentation/widgets/shimer/product/home_product.dart", "Dart", 99, 5, 6, 110
"/Users/abdualhabib/Desktop/bussenes/flutter_project/ams2/lib/presentation/widgets/shimer/product/horizantal_product.dart", "Dart", 99, 5, 6, 110
"/Users/abdualhabib/Desktop/bussenes/flutter_project/ams2/lib/presentation/widgets/shimer/product/shimer_slider.dart", "Dart", 140, 1, 8, 149
"/Users/abdualhabib/Desktop/bussenes/flutter_project/ams2/lib/presentation/widgets/shimer/product/vertical_product.dart", "Dart", 118, 8, 5, 131
"/Users/abdualhabib/Desktop/bussenes/flutter_project/ams2/lib/presentation/widgets/side_menu.dart", "Dart", 166, 23, 12, 201
"/Users/abdualhabib/Desktop/bussenes/flutter_project/ams2/lib/presentation/widgets/small_primary_button.dart", "Dart", 46, 0, 4, 50
"/Users/abdualhabib/Desktop/bussenes/flutter_project/ams2/lib/presentation/widgets/social_button.dart", "Dart", 45, 5, 4, 54
"/Users/abdualhabib/Desktop/bussenes/flutter_project/ams2/lib/presentation/widgets/suggestion_shimmer.dart", "Dart", 12, 0, 3, 15
"/Users/abdualhabib/Desktop/bussenes/flutter_project/ams2/lib/presentation/widgets/text_widget.dart", "Dart", 28, 0, 2, 30
"/Users/abdualhabib/Desktop/bussenes/flutter_project/ams2/lib/simple_bloc_observer.dart", "Dart", 18, 0, 4, 22
"Total", "-", 19060, 1857, 2480, 23397